1111111111
10E0100001
1000000111
10000P00C1
1111100011
100000C001
1100C00111
1111111111
